+---+---+---+---+---+---+---+---+---+---+---+---+---+---+---+---+
|   |                           |               |               |
+   +   +---+---+---+---+---+   +---+   +   +   +   +   +   +   +
|   |                   |   |           |   |   |   |   |   |   |
+   +---+   +   +   +   +   +   +---+   +   +   +---+   +   +   +
|   |   |   |   |   |   |   |           |   |           |   |   |
+   +   +   +   +   +   +   +   +---+---+---+   +---+---+---+   +
|   |   |   |   |   |   |   |                               |   |
+   +   +   +   +   +   +   +   +---+---+---+   +---+---+   +   +
|   |       |   |   |   |   |                               |   |
+   +   +   +   +   +   +   +   +---+---+---+   +---+---+   +   +
|   |   |   |               |                               |   |
+   +   +   +   +   +   +   +   +---+---+---+   +---+---+   +   +
|   |   |   |   |   |   |   |                               |   |
+   +---+   +   +   +   +   +---+---+---+---+---+---+---+---+   +
|               |   |   |   |                               |   |
+   +---+   +   +   +   +   +   +   +---+---+---+---+---+   +   +
|   |   |   |   |   |   |   |       |                           |
+   +   +   +   +   +   +   +---+---+---+---+---+---+---+---+   +
|   |   |   |   |   |   |   |                               |   |
+   +   +   +   +   +   +   +   +---+---+---+   +---+---+   +   +
|   |   |   |               |                               |   |
+   +   +   +   +   +   +   +   +---+---+---+   +---+---+   +   +
|   |       |   |   |   |   |                               |   |
+   +   +   +   +   +   +   +   +---+---+---+   +---+---+   +   +
|   |   |   |   |   |   |   |                               |   |
+   +   +   +   +   +   +   +   +---+---+---+   +---+---+---+   +
|   |   |   |   |   |   |   |           |   |           |   |   |
+   +---+   +   +   +   +   +   +---+   +   +   +---+   +   +   +
|   |                   |   |           |   |   |   |   |   |   |
+   +   +---+---+---+---+---+   +---+   +   +   +   +   +   +   +
|   |                           |               |       |       |
+---+---+---+---+---+---+---+---+---+---+---+---+---+---+---+---+
