*---*---*---*---*---*---*---*---*---*---*---*---*---*---*---*---*
|                                               |               |
*   *---*---*---*---*---*---*---*---*---*---*   *   *---*   *   *
|   |                               |       |   |   |   |   |   |
*   *   *---*---*---*---*---*---*   *   *   *   *   *   *   *   *
|   |   |                       |   |   |   |   |       |   |   |
*   *   *---*---*---*---*---*   *   *   *   *   *---*   *   *   *
|                               |   |   |   |       |   |   |   |
*---*---*---*---*---*---*---*---*   *   *---*---*   *   *   *   *
|                               |   |           |   |   |   |   |
*   *---*---*---*---*---*---*   *   *---*---*   *   *   *   *---*
|   |                       |   |   |           |   |   |       |
*   *   *---*---*---*---*   *   *   *   *---*---*   *   *---*   *
|   |   |                   |       |   |       |   |   |   |   |
*   *   *   *---*---*---*---*---*---*   *   *   *   *   *   *   *
|   |   |   |               |           |   |   |   |       |   |
*   *   *   *---*---*   *   *       *   *   *   *   *---*   *   *
|   |   |               |   |       |   |   |   |   |       |   |
*   *   *---*---*---*---*---*---*---*   *   *   *   *---*---*   *
|   |                                       |   |   |           |
*   *   *---*---*---*---*---*---*---*---*---*   *   *   *---*---*
|   |       |               |       |       |   |   |           |
*   *---*   *   *---*---*   *   *---*   *   *   *   *   *---*   *
|   |   |   |   |       |   |           |   |   |   |   |   |   |
*   *   *   *   *---*   *   *---*---*---*   *   *   *   *   *   *
|   |   |   |   |       |   |           |   |   |   |       |   |
*   *   *   *   *   *   *   *   *---*   *   *   *   *   *---*   *
|   |   |   |   |   |   |   |   |   |   |   |   |   |   |       |
*   *   *   *   *   *   *   *   *   *   *   *   *   *   *   *   *
|   |   |   |   |   |   |   |   |   |   |   |   |   |   |   |   |
*   *   *   *   *   *---*   *   *   *   *   *   *   *---*   *   *
|   |           |               |           |               |   |
*---*---*---*---*---*---*---*---*---*---*---*---*---*---*---*---*
